WWWWWWWWWWWWWWWWWWWWWWWWWWWWWWWWWWWWWWWWWWWWWWWWWWWWWWWWWWWW
W            W    W               W      W         W       W
W            W    W               W      W         W       W
W            H    H      R        W      W         W       W
W            W    W               H      H    R    W       W
W            W    W               W      W         H       W
W            WWWWWWHWWWWWWWWHWWWWWWHW    W         W       W
W            W  W                 W W    W         W       W
W            W  W           WWWWWWW W    W         W       W
WWWWWWWWWWWWHW  W  WWW      W     W W    W         W       W
W               W  WMW      W     W W    W         W       W
W               W  W W      W     W W    W         W       W
WWWWWWWWWWWHWWWWWWWW WWWWWHWW     W WWWWHWWWWWWWWWWWWWHWWWWW
W     M       R          M                            M    W
WWWWWWWWHWWWWWWWHWWWWWWWWWWWWWWWWW   WWWWWWWWWWWWWWWWWHWWWWW
W          W                     W   W                     W
W          W                     W   W                     W
W          W         WWWWWWWWWWWWW   W                     W
W          W         W               W                     W
W          W         W WWWWWWWWWWW   W                     W
W          W         W W         W   W     R               W
W     R    H         WMW         W   W                     W
W          W         WWW         W   W     J               W
W          W                     W   H                     W
W          W      R              W   W         R           W
W          W                     W   W                     W
W          W                     W   W                     W
W          W             R       W   W                     W
W          W                     W S W                     W
WWWWWWWWWWWWWWWWWWWWWWWWWWWWWWWWWWWWWWWWWWWWWWWWWWWWWWWWWWWW 